..........
..........
..........
..........
..........
..........
....x.....
...x.x....
....x.x...
.....xx...
